06 06 06 48 49 50 06 06 06 06 06 06 06 06 06 06 06 06 06 06
06 06 06 56 57 58 06 06 06 06 06 06 06 06 06 06 06 06 06 06 
06 06 06 48 49 50 06 06 06 06 00 01 02 03 04 05 06 06 06 06
06 06 06 24 25 26 03 04 05 06 08 09 10 11 12 13 06 06 06 06
06 06 06 32 33 34 11 12 13 06 16 17 18 19 20 21 06 06 06 06
06 06 06 40 41 42 19 20 21 06 48 49 50 48 49 50 06 06 06 06
06 06 06 06 06 06 24 25 26 51 27 28 29 56 57 58 06 06 06 06
06 06 06 06 06 06 32 33 34 52 35 36 37 24 25 26 51 59 51 59
06 06 06 06 06 06 40 41 42 53 43 44 45 32 33 34 52 60 52 60
06 06 06 06 06 06 06 06 06 06 06 06 06 40 41 42 53 61 53 61
06 06 06 06 06 06 06 06 06 06 06 06 06 06 06 06 06 06 06 06
06 06 06 06 06 06 06 06 06 06 06 06 06 06 06 06 06 06 06 06
